# Example maze.
# Key:
# E: Empty
# W: Wall
# S: Start
# E: Eend

WWWWFWWWWWWWWWW
WWWWEWWWWWWWWWW
WWWWEWWWWWWWWWW
WWWWEWWWWWWWWWW
WWWWEEEEEEEEEWW
WWWWWWWWWWWWEWW
WWWWWWEEEEEEEWW
WWWWWWEWWWWWWWW
WWWWWWEEEEEEWWW
WWWWWWWWWWWSWWW
